0 0 0 0 105 105 0 105 0 0 0 0 105 105 0 0 0 0 0 0 0 0 0 0 0 
0 0 0 0 105 0 0 0 0 0 0 0 0 0 0 0 0 0 0 0 0 0 0 0 0 
0 0 0 0 0 0 0 0 0 0 0 0 0 0 0 105 0 0 105 0 0 0 0 0 0 
0 0 0 0 105 0 0 0 0 0 0 0 0 105 0 0 105 0 105 105 0 0 0 0 0 
0 0 0 0 0 0 0 0 0 0 0 0 105 105 0 105 105 105 0 0 105 0 0 0 0 
0 7 7 0 0 0 0 0 0 0 0 105 0 0 105 0 105 105 0 0 0 0 0 0 0 
7 0 0 0 0 0 105 105 105 0 0 0 0 0 0 0 0 105 0 0 105 0 0 0 0 
0 0 0 0 0 0 105 7 105 7 7 7 7 7 105 7 7 0 0 7 0 0 0 0 0 
7 0 0 0 0 7 105 105 0 0 105 0 0 0 0 0 0 0 0 0 7 0 0 0 0 
0 0 0 0 7 0 105 0 7 0 0 0 0 7 0 0 0 0 0 105 105 7 0 0 0 
0 0 0 0 7 0 105 7 0 105 7 0 0 0 0 7 0 0 0 105 0 7 0 0 0 
7 0 0 0 0 0 0 7 0 0 0 105 7 0 0 105 0 105 0 0 0 0 0 0 0 
7 0 0 0 7 105 0 0 0 105 0 105 105 0 0 0 7 7 0 0 0 0 0 0 0 
0 0 0 0 0 7 0 105 0 0 0 0 0 0 0 0 7 0 7 0 0 7 0 0 0 
7 0 0 0 0 0 0 0 0 0 105 7 0 0 7 0 7 7 0 0 7 0 0 0 0 
0 7 0 7 0 0 0 0 0 0 0 0 105 0 0 0 0 7 0 7 0 0 0 0 0 
0 0 0 0 0 0 0 0 0 0 0 0 0 0 0 0 7 0 0 0 0 0 0 0 0 
0 0 0 0 0 0 0 0 0 0 0 0 0 0 7 7 0 0 0 0 0 0 0 0 0 
